10 | 10
W | W | W | W | W | W | W | W | W | W
W | _ | _ | _ | _ | _ | C | _ | _ | W
W | _ | _ | _ | _ | _ | C | _ | _ | W
W | _ | _ | _ | _ | _ | C | _ | _ | W
W | _ | _ | _ | _ | _ | C | _ | _ | W
W | P | _ |LRR| _ | _ | C | _ |OR | W
W | _ | _ | _ | _ | _ | C | _ | _ | W
W | _ | _ | _ | _ | _ | C | _ | _ | W
W | _ | _ | _ | _ | _ | C | _ | _ | W
W | W | W | W | W | W | W | W | W | W
