10 | 10
W | W | W | W | W | W | W | W | W | W
W | _ | _ | _ | _ | _ | _ | _ | _ | W
W |LRR| _ | _ | _ | _ | _ | _ | _ | W
W | W | _ | _ | _ | _ | _ | _ | _ | W
W | _ | _ | _ | _ | _ | _ | _ | _ | W
W | P | _ | _ | _ | _ | _ |RD | _ | W
W | _ | _ | _ | _ | _ | _ | _ | _ | W
W | _ | _ | _ | _ | _ | _ | _ | _ | W
W | _ | _ |OR | _ | _ | _ | _ | _ | W
W | W | W | W | W | W | W | W | W | W
