9 | 12
_ | _ | _ | _ |RR | _ | _ | _ | _ | _ |LRL| _
_ | _ | _ | _ | _ | _ | _ | _ | _ | _ | _ | _
_ | W | W | W | _ | _ | W | _ | _ | _ | _ | _
_ | W |OR | W | _ | _ | W | _ | _ | _ | _ | _
_ | W | _ | W | _ | _ | W | _ | _ | _ | _ | _
_ | W | _ | W |RU | _ | W | _ | _ | _ | _ | _
_ | W | _ | W | _ | _ | W | _ | _ | _ | _ | _
_ | W | _ | W | _ | _ | W | _ | _ | _ | P | _
_ | _ | _ | _ |RL | _ | W | _ | _ | _ | _ | _
