10 | 10
W | W | W | W | W | W | W | W | W | W
W | _ | _ | _ | _ | _ | _ | _ | _ | W
W | _ | _ | _ | _ | P | _ | _ | _ | W
W | _ | W | W | _ | _ |LRD| _ | _ | W
W | _ |OR | W | _ | _ | _ | _ | _ | W
W | _ | _ | W |RU | _ | _ | _ | _ | W
W | _ | _ | W | _ | _ | W | _ | _ | W
W | _ | _ | W | _ | _ | W | _ | _ | W
W | _ | _ |RL | _ | _ | W | _ | _ | W
W | W | W | W | W | W | W | W | W | W
