10 | 10
W | W | W | W | W | W | W | W | W | W
W | _ | _ | _ | _ | _ | _ | _ | _ | W
W | _ | _ | _ | _ | _ | _ | _ | _ | W
W | _ | W | W | W | _ |LRD| W | _ | W
W | _ | W |OR | W | _ | _ | W | _ | W
W | _ | W | _ | W |RU | _ | W | _ | W
W | _ | W | _ | W | _ | _ | W | _ | W
W | _ | W | _ | W | _ | _ | W | _ | W
W | _ | _ | _ |RL | _ | _ | W | P | W
W | W | W | W | W | W | W | W | W | W
