10 | 10
W | W | W | W | W | W | W | W | W | W
W | _ | _ | _ | _ | _ | _ | _ | _ | W
W |LRR| _ | _ | _ | _ | _ | _ | _ | W
W | W | _ | _ | _ | _ | _ | _ | _ | W
W | _ | _ | _ | _ | _ | _ | _ | _ | W
W | P | _ | _ |LBD| _ | _ |RD | _ | W
W | _ | _ | _ | _ |LBU| _ | _ | _ | W
W | _ | _ | _ | _ | _ | _ |LBL| _ | W
W | _ | _ |OR | _ | _ | _ | _ | _ | W
W | W | W | W | W | W | W | W | W | W
