10 | 10
W | W | W | W | W | W | W | W | W | W
W | _ | _ | _ | _ | _ | _ | _ | _ | W
W |LRR| _ | _ | _ | _ | _ | _ | _ | W
W | _ | _ | _ |RD | _ | _ | _ | _ | W
W | _ | _ | _ | _ | _ | _ | _ | _ | W
W | P |LBD| _ |LBD| _ | _ | _ | _ | W
W | _ | _ | _ | _ | _ | _ |RL | _ | W
W | _ | _ | _ | _ |RU | _ | _ | _ | W
W | _ | _ |OR | _ | _ | _ | _ | _ | W
W | W | W | W | W | W | W | W | W | W
