9 | 13
 _ | _ | _ | _ | _ | _ | _ | _ | _ | _ | _ | _ | _
 _ | _ | _ |SL | _ | _ | _ | _ | _ | _ | _ | _ | _
 _ |LRR| _ |SU |SR |SD | _ | _ | _ | _ | _ | _ | _
 _ | _ | _ | _ | _ |RR |RD |RL |RU | _ | _ | _ | _
 _ |LRR| _ | _ | _ |RR |RD |RL |RU | _ | _ | _ | _
 _ | _ | _ | _ | _ | _ | _ | _ | _ | _ | _ | _ | _
 _ | _ | P | _ | _ | X | _ | _ | _ | _ | _ | _ | _
 _ | _ | _ | _ | _ | _ | _ |OR | _ | _ | _ | _ | _
 _ | _ | _ | _ | _ | _ | _ | _ | _ | _ | _ | _ | _
