9 | 13
 _ | _ | _ | _ | _ | _ | _ | _ | _ | _ | _ | _ | _
 _ | _ | _ | _ | _ | _ | _ | _ | _ |OP | _ | _ | _
 _ | _ | _ | _ | _ | _ | _ | _ | _ | _ | _ | _ | _
 _ | _ | _ | _ | _ | _ | _ | _ | _ | _ | _ | _ | _
 _ |LBR| _ | _ | X | _ | _ | _ | _ | _ | _ |OP | _
 _ | _ | _ | _ | _ | _ | _ | _ | _ | _ | _ | _ | _
 _ | _ |RR | _ | _ | _ | _ | _ | _ | _ | _ | _ | _
 _ | P | _ | _ |LRU| _ | _ | _ | _ | _ | _ | _ | _
 _ | _ | _ | _ | _ | _ | _ | _ | _ | _ | _ | _ | _
