9 | 13
 _ | _ | W | _ | _ | _ | _ | _ | _ | _ | _ | _ | _
 _ | C | W | _ | _ | _ | _ | _ | _ | _ | _ |OR | _
 _ |RL | W | _ | _ | _ | _ | _ | _ | _ | _ | _ | _
 _ | C | W | _ | _ | _ | _ | _ | W | _ | _ | _ | _
 _ | _ | W | _ | _ | _ | _ | _ | W |RR | _ | _ | _
 _ | _ | W | _ | _ | _ | _ | _ | W | _ | _ | _ | _
 _ | _ | W | _ | _ | _ | _ | _ | W | _ | _ | _ | _
LRR| _ | _ | _ | _ | _ | _ | _ | W | _ | _ | P | _
 _ | _ | _ | _ | _ | _ | _ | _ | W | _ | _ | _ | _
