10 | 10
W | W | W | W | W | W | W | W | W | W
W | _ | _ | W | _ | _ | _ | _ | _ | W
W | _ | C | W | _ | _ | _ | P |OR | W
W | _ |RL | W | _ | _ | _ | _ | _ | W
W | _ | _ | W | _ | _ | W | _ | _ | W
W | _ | _ | W | _ | _ | W | _ | _ | W
W |LRR| _ | W | _ | _ | W |RR | _ | W
W | _ | _ | W | _ | _ | W | _ | _ | W
W | _ | _ | _ | _ | _ | W | _ | _ | W
W | W | W | W | W | W | W | W | W | W
