10 | 10
W | W | W | W | W | W | W | W | W | W
W | _ | _ | W | _ | _ | _ | _ | _ | W
W | _ |RU | W | _ | _ | _ | P |OR | W
W | _ |RL | W | _ | _ | _ | _ | _ | W
W | _ | _ | W | _ | _ | W |RD | _ | W
W | _ | _ | W | _ | _ | W |RU | _ | W
W |LRR| _ | _ | _ | _ | W |RL | _ | W
W | _ | _ | _ | _ | _ | W |RD | _ | W
W | _ | _ | _ | _ | _ | W | _ | _ | W
W | W | W | W | W | W | W | W | W | W
