10 | 10
W | W | W | W | W | W | W | W | W | W
W | _ | _ | _ | _ | _ | _ | _ | _ | W
W |LRR| P | C | C | C | C | C |OR | W
W | _ | _ | _ | _ | _ | _ | _ | _ | W
W | _ | W | W | W | W | W | W | _ | W
W | _ | _ | _ | _ | _ | _ | _ | _ | W
W | _ | _ | _ | _ | _ | _ | _ | _ | W
W | _ | _ | _ | _ | _ | _ | _ | _ | W
W | _ | _ | _ | _ | _ | _ | _ | _ | W
W | W | W | W | W | W | W | W | W | W
