10 | 10
W | W | W | W | W | W | W | W | W | W
W | _ | _ | _ | _ | _ | _ | _ | _ | W
W | _ | _ | _ | _ |LBD| _ | _ | _ | W
W | _ | _ | _ | _ | _ | _ | _ | _ | W
W | _ | _ | _ | _ | _ | _ | _ | _ | W
W | _ | _ |LRR| _ | P | _ |OB | _ | W
W | _ | _ | _ | _ | _ | _ | _ | _ | W
W | _ | _ | _ | _ |OR | _ | _ | _ | W
W | _ | _ | _ | _ | _ | _ | _ | _ | W
W | W | W | W | W | W | W | W | W | W
