10 | 10
W | W | W | W | W | W | W | W | W | W
W | _ | _ | _ | _ | _ | C | C | _ | W
W | P | _ | _ | _ | _ | C |OR | C | W
W | _ | _ | _ | _ | _ | C | C | C | W
W | _ | _ | _ | _ | _ | _ | _ | _ | W
W | _ | _ | _ | _ | _ | _ | _ | _ | W
W |LRR| _ | _ | _ | _ | _ | _ | _ | W
W | _ | _ | _ | _ | _ | _ | _ | _ | W
W | _ | _ | _ | _ | _ | _ | _ | _ | W
W | W | W | W | W | W | W | W | W | W
